6
1,1,1,1,0,1,1,1,0,1,0
0,0,1,1,1,1,0,0,0,1,0
0,0,0,1,0,1,1,1,1,1,1
1,1,1,2,0,1,0,1,0,1,0
0,0,1,0,1,0,0,0,1,1,0
0,0,0,1,1,1,1,0,0,0,0
4
8
---------------------
6
2,1,1,1,0,1,1,1,0,1,0
0,0,1,1,1,1,0,0,0,1,0
0,0,0,1,0,1,1,1,1,1,1
1,1,1,1,1,1,0,1,0,1,0
0,0,1,0,1,0,0,0,1,1,0
0,0,0,1,1,1,1,0,0,0,0
0
9
---------------------
3
2,1,0,1,1,1,1,1,1,1,0
0,1,0,1,0,1,0,1,0,1,1
1,1,1,1,1,1,0,1,0,1,0
1
10
---------------------
3
2,1,0,1,1,1,1,1,1,1,0
0,1,0,1,0,1,0,1,0,1,1
1,0,1,0,1,1,0,1,0,1,0
1
10
---------------------